3 69 25
1311111111111111111111111
1212221622221222222222121
1212121111121211121112121
1212122222122222122212121
1212111112111111111212121
1212122212122212221212121
1212121212121212121212121
1212121222121212121212221
1212121111121212121211121
1212122212221222122212121
1212111211121111111112121
1212221222122222122222121
1212121112111112121112121
1212121222122222121212121
1212121112121111121212121
1212122212121222122212121
1212111212121211111212121
1212122212121212222212121
1211121112121212111112121
1222121212121222122212121
1112121212121211121212121
1212121212121212221212121
1212121212121212121112121
1212221222121212122212121
1211111211121211111212121
1222221222121222222212121
1212111112121111111212121
1212122212122212221212121
1212121212111212121212121
1212221222122212121212221
1211111111121112121211111
1222221222121612122212221
1111121212121212111112121
1222221212221222122222121
1211111211111211121111121
1222121222121222121222221
1112121212121112121111121
1212121212122222122222121
1212121212111211121112121
1222121212221212121222121
1211121211121212121211111
1212222212221212121212221
1212111112111212121212121
1212122222122212221222121
1212121111121112111111121
1212122212122212222222121
1211111212111211111112121
1212222212221222122212121
1212111111121112121211121
1212221222122212121222221
1211121212121212121111121
1222121212121212121222121
1112121212121212121212121
1222121212221212121212121
1211121211111112121212111
1212221222122222122212221
1212111212121111111111121
1212121212221222222212221
1212121211111112111212121
1212121212222212121222121
1212121212111212121111121
1212122212221212122222121
1212121111121212121212121
1212121222221212121212121
1212121212111212121212121
1212121212121212121212121
1212121112121212121211121
1222122222122222121222221
1111111111111111111111141
