13111111111111111111111111111111111111111111111111111111111
15155555155512222555555512122222221222122555555512222212221
15151115151511111511111512121111121212121511111512111212121
15551215151515551555551512221222221212121555121512221212121
11111215151515151211151511111211111212121115121512121211121
12155515151555151212151555551212221212121555121512121222121
12151515151111151212151111151212121212121511121511121112121
12151555151215551212151225551222122212221555121555122212121
12151111151215111212151115111211111111121115121115121212121
12151555151215551212155515122215551555121555155555121212221
12151515151211151212111515111115151515111511151111121211121
15551515151555151212221515155555155515555512151222221222121
15111515151515151212111515151111111111111112151111111112111
15551515151515551222155515151622122222122222151555555512221
11151515151511111211151115151112121211121212151511111512121
15551515151512222215551555155512121212221212151512255512121
15111515151512111115111511111512121212111212151511151112121
15551515551512155555121512255512221222121212151555155512121
11151511111511151111121512151211111211121211151115111511121
12151555551555551215555512151215551222221222155515551555551
12151211151111111215111111151215151211111112111511151111151
12151222155512222215551225551215151212222212221555155515551
12151112111512111211151115111115151212111212111115121515111
15551222155512221222151555155555151212122222155515121515551
15111111151112121111151511151111151112121111151515121511151
15122555151222121555151515551222155512121555151555121512151
15111515151211121515151515111112111512121515151111111512151
15155515551212121515551515551222155512121515551555555512151
15151111111212121511111511151212151112111511111511111112151
15551222122212121555122555552212151222155515555512222222151
11111212121112121115111111111111151212151115111112111111151
12222212222222122225555555555555551212255555122222222222251
11111111111111111111111111111111111111111111111111111111141
---
length=520
time=894
